.. .. .. .. .. w0 w0 w0 .. 
e0 .. .. .. .. t0 .. .. w0
c2 w0 .. .. .. .. .. .. w0
.. .. w0 .. w0 .. .. .. w0
.. .. .. .. w0 .. w0 w0 ..
.. .. .. .. .. .. .. .. ..
.. .. .. .. .. .. .. .. ..
w0 .. w0 s6 w0 .. w0 w0 w0
.. .. .. .. .. .. .. .. ..
.. .. .. .. .. .. .. .. ..
.. w0 w0 .. w0 w0 .. .. ..